@{
eastasia='southeastasia';
southeastasia='eastasia';
australiaeast='australiasoutheast';
australiasoutheast='australiaeast';
canadacentral='canadaeast';
canadaeast='canadacentral';
chinanorth='chinaeast';
chinaeast='chinanorth';
centralindia='southindia';
southindia='centralindia';
japaneast='japanwest';
japanwest='japaneast';
koreacentral='koreasouth';
koreasouth='koreacentral';
northcentralus='southcentralus';
southcentralus='northcentralus';
eastus='westus';
westus='eastus';
eastus2='centralus';
centralus='eastus2';
westus2='westcentralus';
westcentralus='westus2';
northeurope='westeurope';
westeurope='northeurope';
brazilsouth='southcentralus';
usgoviowa='usgovvirginia';
usgovvirginia='usgovtexas';
usgovtexas='usgovarizona';
usgovarizona='usgovtexas';
ukwest='uksouth';
uksouth='ukwest';
germanycentral='germanynortheast';
germanynortheast='germanycentral';
}